R 1080 720

NO    textures/gab.xpm
SO     textures/wall.xpm
EA textures/metal.xpm
WE textures/mountain.xpm

S sprites/gordon.xpm
F    50,  75 , 100
C   64  ,115,150

        1111111111111111111111111
        1000000000110000000000001
        1011000001110000002000001
        1001000000000000000000001
111111111011000001110000000000001
120000000011000001110111111111111
11110111111111000000000000001
11110111111111000001010010001
11000000110101000000000000201
10002000000000001100000010201
10000000000000001101010000001
11000001110101011111011010N01
11110111 1112101 101111210001
11111111 1111111 111111111111
